S ##### ##
# #  #   #
#   ##  ##
#        #
#   ######
#  #E#####
#  #   ###
#  ### ###
#        #
##########