### ##
## S #
#    #
# ## #
#### #
#E   #
######